111111111111111111111111111111111
11P000000001111100001111111111111
1111111110011111CC100001111000001
111111111001111101111001100011101
1CCCCCC0000000000111100LL00011101
1CCLCLC00001111111111111111111001
111111111100000000000000000000011
111111111111111111101111111111111
111111111111111111101111111111111
111111111111111110001111111111111
111111111111111110111111111111111
11111111111111111F111111111111111
000000000000000011100000000000000
111111111111111111111111111111111
11P000000001111100001111111111111
1111111110011111CC100001111000001
111111111001111101111001100011101
1CCCCCC0000000000111100LL00011101
1CCLCLC00001111111111111111111001
111111111100000000000000000000011
111111111111111111101111111111111
111111111111111111101111111111111
111111111111111110001111111111111
111111111111111110111111111111111
11111111111111111F111111111111111
000000000000000011100000000000000
111111111111111111111111111111111
11P000000001111100001111111111111
1111111110011111CC100001111000001
111111111001111101111001100011101
1CCCCCC0000000000111100LL00011101
1CCLCLC00001111111111111111111001
111111111100000000000000000000011
111111111111111111101111111111111
111111111111111111101111111111111
111111111111111110001111111111111
111111111111111110111111111111111
11111111111111111F111111111111111
000000000000000011100000000000000